1111111111111111
1000000000000001
10P0000000000001
1000000111000001
1000011101100001
1000110000100001
1001100000111001
1001000000001001
1001111000011001
1000001111110001
1000000000000001
1111111111111111